; This is a test of the comments
       
   .   
   $   
 .$@$. 
   $   
   .   
       
;
   ###
  ## # ####
 ##  ###  #
## $      #
#   @$ #  #
### $###  #
  #  #..  #
 ## ##.# ##
 #      ##
 #     ##
 #######
;
    #####
   ## . #
  ## $. #
 ## $   #
## $@ ###
# $  ##
#.. ## 
#   # 
##### 
